16
16
0000000000000000
0112221111222110
0112111111112110
0112111111112110
0111111221111110
0111111221111110
0112111111112110
0222221111222220
0222221111222220
0112111111112110
0111111221111110
0111111221111110
0112111111112110
0112111111112110
0112221111222110
0000000000000000