8
8
00000000
01300310
01211210
01111110
01111110
01211210
01300310
00000000