8
8
11111111
12323321
12323321
12222221
12222221
12332321
12332321
11111111