8
8
00000000
01111110
01111110
01122110
01122110
01111110
01111110
00000000