16
16
0000000000000000
0310001111000130
0112311111132110
0112111111112110
0111111221111110
0111111221111110
0112311111132110
0000001111000000
0000001111000000
0112311111132110
0111111221111110
0111111221111110
0112111111112110
0112311111132110
0310001111000130
0000000000000000