8
8
00000000
01122110
01211210
01111110
01111110
01211210
01122110
00000000