8
8
00000000
01131110
01211210
01100130
03100110
01211210
01113110
00000000