8
8
11111111
12233221
12322321
12222221
12222221
12322321
12233221
11111111
