8
8
00000000
01300310
01211210
00000000
00000000
01211210
01300310
00000000