8
8
111111111
22333311
32233211
23232311
22322311
32322211
23333211
11111111
11111111
22333311
32233211
23232311
22322311
32322211
23333211
11111111
11111111
22333311
32233211
23232311
22322311
32322211
23333211
11111111
11111111
22333311
32233211
23232311
22322311
32322211
23333211
11111111
11111111
22333311
32233211
23232311
22322311
32322211
23333211
11111111
11111111
22333311
32233211
23232311
22322311
32322211
23333211
11111111
11111111
22333311
32233211
23232311
22322311
32322211
23333211
11111111
11111111
22333311
32233211
23232311
22322311
32322211
23333211
11111111
11111111
22333311
32233211
23232311
22322311
32322211
23333211
11111111
11111111
22333311
32233211
23232311
22322311
32322211
23333211
11111111
11111111
22333311
32233211
23232311
22322311
32322211
23333211
11111111
11111111
22333311
32233211
23232311
22322311
32322211
23333211
11111111
11111111
22333311
32233211
23232311
22322311
32322211
23333211
11111111
11111111
22333311
32233211
23232311
22322311
32322211
23333211
11111111
11111111
22333311
32233211
23232311
22322311
32322211
23333211
11111111
11111111
22333311
32233211
23232311
22322311
32322211
23333211
11111111
11111111
22333311
32233211
23232311
22322311
32322211
23333211
11111111
11111111
22333311
32233211
23232311
22322311
32322211
23333211
11111111
11111111
22333311
32233211
23232311
22322311
32322211
23333211
11111111
11111111
22333311
32233211
23232311
22322311
32322211
23333211
11111111
11111111
22333311
32233211
23232311
22322311
32322211
23333211
11111111
11111111
22333311
32233211
23232311
22322311
32322211
23333211
11111111
11111111
22333311
32233211
23232311
22322311
32322211
23333211
11111111
11111111
22333311
32233211
23232311
22322311
32322211
23333211
11111111
11111111
22333311
32233211
23232311
22322311
32322211
23333211
11111111
11111111
22333311
32233211
23232311
22322311
32322211
23333211
11111111
11111111
22333311
32233211
23232311
22322311
32322211
23333211
11111111
11111111
22333311
32233211
23232311
22322311
32322211
23333211
11111111
11111111
22333311
32233211
23232311
22322311
32322211
23333211
11111111
11111111
22333311
32233211
23232311
22322311
32322211
23333211
11111111
11111111
22333311
32233211
23232311
22322311
32322211
23333211
11111111
11111111
22333311
32233211
23232311
22322311
32322211
23333211
11111111
11111111
22333311
32233211
23232311
22322311
32322211
23333211
11111111
11111111
22333311
32233211
23232311
22322311
32322211
23333211
11111111
11111111
22333311
32233211
23232311
22322311
32322211
23333211
11111111
11111111
22333311
32233211
23232311
22322311
32322211
23333211
11111111
11111111
22333311
32233211
23232311
22322311
32322211
23333211
11111111
11111111
22333311
32233211
23232311
22322311
32322211
23333211
11111111
11111111
22333311
32233211
23232311
22322311
32322211
23333211
11111111
11111111
22333311
32233211
23232311
22322311
32322211
23333211
11111111
11111111
22333311
32233211
23232311
22322311
32322211
23333211
11111111
11111111
22333311
32233211
23232311
22322311
32322211
23333211
11111111
11111111
22333311
32233211
23232311
22322311
32322211
23333211
11111111
11111111
22333311
32233211
23232311
22322311
32322211
23333211
11111111
11111111
22333311
32233211
23232311
22322311
32322211
23333211
11111111
11111111
22333311
32233211
23232311
22322311
32322211
23333211
11111111
11111111
22333311
32233211
23232311
22322311
32322211
23333211
11111111
11111111
22333311
32233211
23232311
22322311
32322211
23333211
1111111