8
8
11111111
12233331
13223321
12323231
12232231
13232221
12333321
11111111
